26 20
30 200
0 0 0 0 0 0 0 0 0 0 0 0 0 0 0 0 0 0 0 0 0 0 0 0 0 19
0 0 30 0 17 17 0 0 0 0 0 0 0 0 0 0 17 17 17 0 0 0 0 0 0 19
0 0 14 15 15 16 0 0 0 0 0 0 0 0 0 0 17 17 17 0 0 0 0 0 0 19
0 0 0 0 0 0 0 0 0 0 0 0 14 15 15 16 0 0 0 0 0 0 0 0 0 19
0 0 0 0 0 0 0 0 0 0 0 0 0 0 0 0 0 0 0 0 0 1 2 2 2 19
0 0 0 0 0 0 0 0 0 0 0 0 0 0 0 0 0 14 15 16 0 4 5 5 5 0
0 0 0 0 0 0 0 0 14 15 16 0 0 0 0 0 0 0 0 0 0 4 5 5 5 0
0 0 0 0 0 0 0 0 0 0 0 0 0 0 0 0 0 0 0 0 0 12 9 9 9 0
0 0 0 0 0 14 15 16 0 0 0 0 0 0 0 0 0 0 0 0 0 0 0 0 0 0
0 0 0 0 0 0 0 0 0 0 0 0 0 0 0 0 0 0 0 0 0 0 0 0 0 19
0 0 0 0 0 0 0 0 0 0 17 17 17 17 17 0 0 0 17 17 17 17 17 0 0 19
2 2 2 3 0 0 0 0 0 17 0 0 0 0 0 17 0 17 0 0 0 0 0 17 0 19
5 5 5 6 0 0 0 14 15 16 0 0 0 0 0 14 15 16 0 0 0 0 0 14 15 16
5 5 5 6 0 0 0 0 0 0 0 0 0 0 0 0 0 0 0 0 0 0 0 0 0 0
5 5 5 6 0 0 0 0 0 0 0 0 0 0 0 0 0 0 0 0 1 2 3 0 0 0
5 5 5 6 0 0 1 2 2 2 2 2 2 2 2 2 3 0 0 0 4 5 6 0 0 0
5 5 5 6 0 0 4 5 5 5 5 5 5 5 5 5 6 0 0 0 4 5 6 0 0 0
5 5 5 6 0 0 4 5 5 5 5 5 5 5 5 5 6 0 0 0 4 5 6 0 0 0
5 5 5 6 0 0 4 5 5 5 5 5 5 5 5 5 6 0 0 0 4 5 6 0 0 0
5 5 5 6 0 0 4 5 5 5 5 5 5 5 5 5 6 0 0 0 4 5 6 0 0 0