26 20
250 100
0 0 0 0 0 0 0 0 0 0 0 0 0 0 0 0 0 0 0 0 0 0 0 0 0 19
0 0 30 0 0 0 0 0 0 0 0 0 0 0 0 0 0 0 0 0 0 0 0 0 0 19
0 0 14 15 15 16 0 0 0 0 0 0 0 0 0 0 0 0 0 0 0 0 0 0 0 19
0 0 0 0 0 0 0 0 0 0 0 0 14 15 15 16 0 0 0 0 0 0 0 0 0 19
0 0 0 0 0 0 0 0 0 0 0 0 0 0 0 0 0 0 0 0 0 1 2 2 2 19
2 3 0 0 0 0 0 0 0 0 0 0 0 0 0 0 0 14 15 16 0 4 5 5 5 0
5 6 0 0 0 0 0 0 14 15 16 0 0 0 0 0 0 0 0 0 0 4 5 5 5 0
5 6 0 0 0 0 0 0 0 0 0 0 0 0 0 0 0 0 0 0 0 12 9 9 9 0
5 6 0 0 0 0 0 0 0 0 0 0 0 0 0 0 0 0 0 0 0 0 0 0 0 0
9 13 0 0 0 0 0 14 15 15 16 0 0 0 0 0 0 0 0 0 0 0 0 0 0 19
0 0 0 0 0 0 0 0 0 0 0 0 0 0 0 0 0 0 0 0 0 0 0 0 0 19
0 0 0 0 0 0 0 0 0 0 0 0 0 0 0 0 0 0 0 0 0 0 0 0 0 19
0 0 0 0 14 15 15 16 0 0 0 0 0 0 1 2 3 0 0 0 0 14 15 15 16 0
0 0 0 0 0 0 0 0 0 0 0 0 0 14 4 5 6 0 0 0 0 0 0 0 0 0
19 0 0 0 0 0 0 0 0 0 0 0 0 0 4 5 6 0 0 0 0 0 0 0 0 0
2 2 2 3 0 0 1 2 2 2 2 2 2 2 8 5 6 0 0 0 1 2 3 0 0 0
5 5 5 6 0 0 4 5 5 5 5 5 5 5 5 5 6 0 0 0 4 5 6 0 0 0
5 5 5 6 0 0 4 5 5 5 5 5 5 5 5 5 6 0 0 0 4 5 6 0 0 0
5 5 5 6 0 0 4 5 5 5 5 5 5 5 5 5 6 0 0 0 4 5 6 0 0 0
5 5 5 6 18 18 4 5 5 5 5 5 5 5 5 5 6 18 18 18 4 5 6 18 19 0
